NO ./textures/Textures-1.xpm
SO ./textures/Textures-2.xpm
WE ./textures/Textures-3.xpm
EA ./textures/Textures-4.xpm

F 99,62,0
C 102,170,255

111111111111111111111111
10000000000000000000001
 1000000000000000000001
  10000000S00000000001
   100000000100000001
    1000000000000001
     10000000000001
      100000000001
       1000000001
        10000001
         101101
          1001
           11
